~~~~~~~~~~~~
~..........~
~.C........~
~..........~
~........C.~
~..........~
~..........~
~C.........~
~..........~
~......C..T~
~........TT~
~~~~~~~~~~~~
